0000000000
0111111110
0100101010
0111101110
1100111011
1101101011
0111011110
0010110010
0111101110
0000000000

0000000000
0111111110
0100110010
0110110110
0010110100
0110000110
0100111010
0110100110
0011111100
0000000000

0000000000
0111111110
0111111110
0111000110
0101110110
0100000110
0111111110
0111111110
0111111110
0000000000

0000000000
0111111110
0111111110
0110001110
0110101110
0110001110
0111111110
0111111110
0111111110
0000000000

0000000000
0111001110
0111111110
0010110100
1110110111
0010000100
0111111110
0100110010
0110110110
0000000000



















